1111111111111111111
1000000000000000001
100000000C000010001
1000000000E01010001
1000000000000010P01
1111111111111111111
