1111111111111111111
1001010001000000001
110001101C100010001
1E01000000001010101
1001010000000011P11
1111111111111111111
