11111111111
10000000001
10E0100C001
10001001001
10P01000001
11111111111