11111111111
10C11000011
1C101000001
1EPC0000001
1CC11000001
11111111111
