11111111111
10000000011
100C0E00001
10000000001
10000P00001
11111111111
