111111111111111111111111111111
1P00000000000100000000000000C1
101111111111010111111111111101
101000000001010100000000000101
101011111101010101111111110101
10101C000101010101000000C10101
101011110101010101011111110101
100000010101010101010000000101
111111010101000101010111111101
100000010101111101010000000101
101111110100000001011111110101
101C00000111111111000000000101
101111110000000000011111110101
100000011111111111110000C10101
111111000000000000000111110101
1C00000011111111111100000000E1
111111111111111111111111111111