111111111111111111111111111111
1P0000000000000000000000000001
100000000000000000000000000001
10001111000000C000000111100001
100010010000000000000100100001
100010010000111100000100100001
1000111100001CC100000111100001
1000000000001CC100000000000001
100000000000110100000000000001
100000000000000000000000000001
100011110000000000000111100001
10001001000000E000000100100001
100010010000111100000100100001
100011110000000000000111100001
100000000000000000000000000001
100000000000000000000000000C01
111111111111111111111111111111