111111111111111111111111111111
1P1C00000000000000000000000001
101011111111111111111111111011
10100000000000000000000000C101
101011111111101111111111110101
101010000000000000000000C10101
101010111111111111111111010101
1010101000000000000000C1010101
101010101111111111111101010101
10101010100000000000C101010101
101010101011111111110101010101
10101010100E000000010101010101
101010101111111111110101010101
101010100000000000000101010101
101011111111111111111101010101
100000000000000000000001010101
111111111111111111111111111111