111111111111111111111111111111
1P00000000000000000000000000C1
101111100000011100000011111001
101N0000000001C0000000000N1001
101111100000011100000011111001
100000000000000000000000000001
100000000000000000000000000001
10000000000000E000000000000001
100000000000000000000000000001
100000000000000000000000000001
101111100000011100000011111001
101N0000000001C0000000000N1001
101111100000011100000011111001
100000000000000000000000000001
1000000000000000000000000000C1
1C0000000000000000000000000001
111111111111111111111111111111