111111111111111111111111111111
1P00000000000010000000000000C1
101111111111101011111111111101
100000000000001000000000000001
101111111111101011111111111101
100000000000001000000000000001
10111111111N10101N111111111101
101C00000000000000000000000C01
101111111111111111111111111101
101C00000000000000000000000C01
10111111111N10101N111111111101
100000000000001000000000000001
101111111111101011111111111101
100000000000001000000000000001
101111111111101011111111111101
10000000000000E000000000000001
111111111111111111111111111111