111111111111111111111111111111
1P00000001110000011100000000C1
1111111101N1011101N10111111111
1C000000000000C000000000000001
111111111111111111111111111101
100000000000000000000000000001
101111111111111111111111111111
101N1000000000E0000000001N1001
101110000000000000000000111001
100000000000000000000000000001
111111111111111111111111111101
1C000000000000C000000000000001
1111111101N1011101N10111111111
100000000111000001110000000001
101111111111111111111111111101
100000000000000000000000000001
111111111111111111111111111111